jimm aspro=Jimm aspro
Miranda=Miranda IM
magent=Mail Agent
jagent=Mobile Agent
sagent=Symbian Agent
wmagent=WM Agent
webagent=Web Agent
Qip Infium=Qip Infium
QIP 2010=QIP 2010
QIP PDA=QIP PDA
R&Q=R&Q
&ML=&ML
bayanicq=Bayan
macagent=Mail.Ru Agent (Mac OS)
android=Mail.ru Agent (Android)
iphoneagent=Mail.ru Agent (iPhone)
MobileJMEICQ=ICQ Mobile (java)
QIP Mobile iPhone=QIP Mobile (iPhone)
QIP Mobile Symbian=QIP Mobile (Symbian)
QIP Mobile (Java)=QIP Mobile (Java)
QIP PDA Symbian=QIP PDA (Symbian)
QIP Mobile iOS=QIP Mobile (iOS)
QIP PDA WM=QIP PDA (WM)
QIP Mobile WM=QIP Mobile (WM)
IMadering=IMadering Client
OrangeIM=OrangeIM
motoagent=MotoMRA
MobiQ=MobiQ IM
Virtus=Virtus
qutIM=qutIM
uim=uIM
Mandarin IM=Mandarin IM
Jasmine IM=Jasmine IM
